111111111111111111
10000000000P000CE1
100100001000100001
111111111000100001
1C0000000000000001
1E0000000000000001
111111111111111111